; Màn 1
#########
###  ####
#  B    #
# # ### #
# # *P# #
#   T## #
####    #
#########