; Màn 2
#########
#   #####
# # B B #
# TT#   #
## T B ##
##  # P##
#########