; Màn 3
######
#    #
# TB #
##TB###
##TB  #
##  P #
##  ###
#######