; Màn 4
######
#   ##
#    #
#PBB #
### ##
#TT T#
# #  #
# B  #
##   #
######
