; Màn 5
#########
#   #   #
#   T   #
## #*####
#   * B #
#   * P #
#########