; Màn 6
#######
#T T  #
#T *  #
## # ##
# BBB #
#  P  #
#######