; Màn 8
########
#  #   #
#T TT  #
#BB### ##
# B     #
#   # P #
#########