; Màn 9
########
#   ####
# BB   #
#TTTTT #
###B#B##
### B ##
###  P##
########