; Màn 10
#######
#  #  #
# B#B #
#  T  #
#T###T#
#  T  #
# B#B #
#P #  #
#######