; Màn 11
#########
#       #
# B## # #
# TT# B #
##TT#B###
##   B  #
##P #   #
#########