; Màn 12
###########
#  P   #  #
## ## *B  #
# T  *  T #
#  B* ## ##
#  #      #
###########