; Màn 13
#######
#     #
#   BB#
# ##  ##
#  #B  #
##T#   #
# T##B##
# T    #
# T P  #
########