; Màn 14
########
#     ##
# *** ##
# *@* ##
# ***  #
#    B #
####   #
########