; Màn 15
######
###  ###
#  B   #
#PB B  #
####B###
##TT  #
## T  #
## *BT#
## T  #
#######