; Màn 16
#########
## P  ###
##B #BB #
# BTTT  #
# #T#T# #
#  TTTB #
# BB# B##
###    ##
#########