; Màn 17
#########
#####   #
#####B  #
#####  B##
###  B B #
### # ## #    #####
#   # ## #####  TT#
# B  B          TT#
##### ### #P##  TT#
#####     #########
###################