; Màn 18
#############
####  *  ####
###  * *  ###
##  * # *  ##
## #  B  # ##
# * TBTBT * #
#   # P #   #
##### # #####
#############