; Màn 19
#########
###     #
###B#B# #
# BTTTB #
# #T T# #
# BTTTB #
# #B#B# #
#P      #
#########