; Màn 20
###########
#   ##    #
# B  B BB #
# B *#T   #
#  TTTT*  #
# B#TPT#B #
#  *TTTT  #
#   T#* B #
# BB B  B #
#    ##   #
###########