; Màn 21
############
####TTTT####
####TTTT####
####    ####
#####  #####
#TT  BB  TT#
#T  B  B  T#
#  B  P B  #
#    ##    #
# B B  B B #
# B B  B B #
#          #
#####  #####
############