; Màn 22
###############
#          TT #
# T T  B T T  #
# BB# T  B #B #
#T  #T  T  #T #
#  B  B # B#B #
# B# B # TBT  #
# TB T T  B B #
#    B BB T * #
#  P    T     #
###############