; Màn 23
#################
#TTTTTTTTTTTTTTT#
#T      T      T#
##             ##
#    B     B    #
#   B#BB BB#B   #
#   B   B   B   #
#    B     B    #
#     B   B     #
#      B#B      #
#       B       #
#       P       #
#################