; Màn 24
#################
#TTTTTTT    B   #
##TTTTTT    #   #
#TTTTTTT   BBB  #
#      B        #
#     BBB       #
#B     B    B   #
#     P   B#B#B #
##  BBBBB   B   #
###             #
#################
