; Màn 25
################
#T         B T##
#T  B     B#B T#
#T B#B     B  T#
#T  B     B#B T#
#T            T#
#T        B#B T#
#T B#B        T#
#T            T#
#T B#B     B  T#
#T  B     B#B T#
#T B#B  P  B  T#
##T B         T#
################
